%%%%%%%%%%%%%%%%%%
%.     .  P.    .%
%%%%%%%%%%%%%%%%%%
